-------------------------------------------------
---------------00--------------------------------
-------------000000------------------------------
---------0000000000000---------------------------
-----00000000000000000000------------------------
--00000000000000000000000000---------------------
-000000000000000--00000000000000-----------------
-0000000000000------0000000000000000-------------
-0000000000000------0000000000000000-------------
-0000000000000------0000000000000000-------------
-0000000000000------0000000000000000-------------
-0000000000000------0000000000000000-------------
-0000000000000------0000000000000000-------------
-0000000000000------0000000000000000-------------
-000000000000X-----0000000000000000S-------------
-------------------------------------------------