--------------------------------------------------------------------------------------------------
---------------00-----------------------------------------------00--------------------------------
-------------000000-------------------------------------------000000------------------------------
---------0000000000000------------------------------------0000000000000---------------------------
-----00000000000000000000-----------------------------00000000000000000000------------------------
--00000000000000000000000000-----------------------00000000000000000000000000---------------------
-000000000000000--00000000000000------------------000000000000000--00000000000000-----------------
-0000000000000------0000000000000000--------------0000000000000------0000000000000000-------------
-0000000000000------0000000000000000--------------0000000000000------0000000000000000-------------
-0000000000000------0000000000000000--------------0000000000000------0000000000000000-------------
-0000000000000------0000000000000000--------------0000000000000------0000000000000000-------------
-0000000000000------00000000000000000000000-------0000000000000------0000000000000000-------------
-0000000000000------0000000000000000--------------0000000000000------0000000000000000-------------
-0000000000000------0000000000000000--------------0000000000000------0000000000000000-------------
-000000000000X------0000000000000000--------------0000000000000------0000000000000000-------------
--------------------0000000000000000--------------0000000000000------0000000000000000-------------
--------------------0000000000000000--------------0000000000000------000000000000000S-------------
--------------------0000000000000000--------------0000000000000-----------------------------------
---------------------000000000000000--------------000000000000------------------------------------
----------------------000000000000000------------000000000000-------------------------------------
-----------------------000000000000000----------000000000000--------------------------------------
-------------------------00000000000000--------00000000000----------------------------------------
---------------------------00000000000000----0000000000-------------------------------------------
-----------------------------000000000000000000000000---------------------------------------------
--------------------------------000000000000000000------------------------------------------------
-----------------------------------000000000000---------------------------------------------------
--------------------------------------000000------------------------------------------------------
----------------------------------------00--------------------------------------------------------
--------------------------------------------------------------------------------------------------